0 0 0 0 0 0 0 0 0 0 0 0 0 0 0 0 0 0 0 0 0 0 0 0 0 0 0 0 0 0 0 0 0 0 0 0 0 0 0 0 0 0 0 0 0 0 0 0 0 0
0 2 2 2 2 2 2 2 2 2 2 2 2 2 2 2 2 2 2 2 2 2 2 2 2 2 2 2 2 2 2 2 2 2 2 2 2 2 2 2 2 2 2 2 2 2 2 2 2 0
0 2 2 2 2 2 2 2 2 2 2 2 2 2 2 2 2 2 2 2 2 2 2 2 2 2 2 2 2 2 2 2 2 2 2 2 2 2 2 2 2 2 2 2 2 2 2 2 2 0
0 2 2 2 2 2 2 2 2 2 2 2 2 2 2 2 2 2 2 2 2 2 2 2 2 2 2 2 2 2 2 2 2 2 2 2 2 2 2 2 2 2 2 2 2 2 2 2 2 0
0 2 2 2 2 2 2 2 2 2 2 2 2 2 2 2 2 2 2 2 2 2 2 2 2 2 2 2 2 2 2 2 2 2 2 2 2 2 2 2 2 2 2 2 2 2 2 2 2 0
0 2 2 2 2 2 2 2 2 2 2 2 2 2 2 2 2 2 2 2 2 2 2 2 2 2 2 2 2 2 2 2 2 2 2 2 2 2 2 2 2 2 2 2 2 2 2 2 2 0
0 2 2 2 2 2 2 4 4 4 4 4 4 4 4 4 4 4 4 4 4 4 4 4 4 4 4 4 4 4 4 4 4 4 4 4 4 4 4 4 4 4 4 2 2 2 2 2 2 0
0 2 2 2 2 2 2 4 6 6 6 3 6 3 3 3 3 3 6 6 6 6 6 3 2 2 2 2 2 2 2 2 2 2 2 2 2 2 5 6 6 5 4 2 2 2 2 2 2 0
0 2 2 2 2 2 2 4 6 6 6 3 6 3 3 3 3 6 6 6 6 6 6 3 2 2 2 2 2 2 2 2 2 2 2 3 2 2 5 6 6 5 4 2 2 2 2 2 2 0
0 2 2 2 2 2 2 4 6 6 6 3 6 3 3 3 6 6 6 3 3 3 6 3 2 2 2 2 2 2 4 2 2 2 5 5 5 5 5 6 6 5 4 2 2 2 2 2 2 0
0 2 2 2 2 2 2 4 6 6 6 3 6 6 6 6 6 6 3 2 2 3 6 3 2 2 2 2 2 2 2 2 2 2 5 6 6 6 6 6 6 5 4 2 2 2 2 2 2 0
0 2 2 2 2 2 2 4 6 6 6 5 6 6 6 6 6 3 5 5 5 5 6 5 5 5 5 2 2 2 2 2 2 2 5 6 6 6 6 6 6 5 4 2 2 2 2 2 2 0
0 2 2 2 2 2 2 4 6 6 6 5 4 3 3 3 3 5 6 6 6 6 6 6 6 6 6 5 2 2 2 3 2 2 5 6 6 6 6 5 5 5 4 2 2 1 1 2 2 0
0 2 2 2 2 2 2 4 6 6 6 6 5 2 2 2 2 5 6 6 6 1 1 1 6 6 6 5 2 2 2 2 2 2 5 6 6 6 6 5 5 5 4 2 2 1 1 2 2 0
0 2 2 2 2 2 2 4 6 6 6 6 5 2 2 4 2 5 6 6 6 1 1 1 6 6 6 5 2 2 2 2 2 2 5 6 6 6 6 6 6 6 4 2 2 2 2 2 2 0
0 2 2 2 2 2 2 4 6 6 6 6 5 2 2 2 2 2 5 6 6 6 6 6 6 6 5 2 2 2 1 1 2 2 5 6 6 6 6 6 6 6 4 2 2 2 2 2 2 0
0 2 2 2 2 2 2 4 6 6 6 6 5 2 3 2 2 2 2 5 6 6 6 6 6 5 2 2 2 2 2 2 2 2 5 5 5 5 5 6 6 6 4 2 2 2 2 2 2 0
0 2 2 2 2 2 2 4 6 6 6 6 5 2 2 2 5 2 2 2 5 6 6 6 5 2 2 2 2 2 4 2 2 3 2 2 2 2 5 6 6 6 4 2 2 2 2 2 2 0
0 2 2 2 2 2 2 4 6 6 6 6 5 2 2 2 2 2 2 2 5 6 6 6 5 2 2 2 2 2 2 2 2 2 2 2 2 2 5 6 6 6 4 2 2 2 2 2 2 0
0 2 2 2 2 2 2 4 6 6 6 6 5 2 2 2 3 2 2 2 5 6 6 6 5 5 5 5 5 5 5 5 5 5 5 5 5 5 5 6 6 6 4 2 2 2 2 2 2 0
0 2 2 2 2 2 2 4 6 6 6 5 2 2 2 2 2 2 2 2 5 6 6 6 6 6 6 6 6 6 6 6 6 6 6 6 6 6 6 6 6 6 4 2 2 2 2 2 2 0
0 3 3 3 3 3 3 4 6 6 5 2 2 2 2 4 4 2 2 2 5 6 6 6 6 6 6 6 6 6 6 6 6 6 6 6 6 6 6 6 6 6 4 2 2 2 2 2 2 0 // DE PE LINIA ASTA INCEP + DE LA 8 IN COLO
0 3 1 1 1 1 1 4 6 5 2 2 2 2 2 2 2 2 2 2 5 5 5 5 5 5 5 5 5 5 5 5 5 5 5 5 5 5 5 6 6 6 4 2 2 2 2 2 2 0
0 3 1 1 1 1 1 4 6 6 5 2 2 2 2 1 1 2 3 2 2 2 2 2 2 2 2 2 2 2 2 2 2 4 4 4 2 2 5 6 6 6 4 2 2 2 2 2 2 0
0 3 1 1 1 1 1 4 6 6 6 5 2 2 2 1 1 2 2 2 2 5 2 2 2 2 2 2 2 2 2 2 2 5 5 5 2 5 6 6 6 6 4 2 2 2 2 2 2 0
0 3 1 1 1 1 1 4 6 6 6 5 2 2 2 2 2 2 2 2 2 2 2 2 2 3 2 2 2 2 1 1 2 2 2 2 5 6 6 6 6 6 4 2 2 2 2 2 2 0
0 3 1 1 1 1 1 4 6 6 6 5 2 2 2 2 2 2 3 2 2 2 2 2 2 2 2 2 2 2 2 2 2 2 2 5 6 6 6 6 6 6 4 2 2 2 2 2 2 0
0 3 3 3 3 3 3 4 6 6 6 6 5 2 2 2 2 2 2 2 2 2 4 2 2 2 2 2 2 2 2 2 2 2 2 5 6 6 6 6 6 6 4 2 2 2 2 2 2 0
0 2 2 2 2 2 2 4 6 6 6 6 5 2 2 2 2 4 2 2 2 2 2 2 2 2 2 2 2 2 2 2 2 2 2 5 6 6 6 6 6 6 4 2 2 2 2 2 2 0
0 2 2 2 2 2 2 4 6 6 6 6 5 2 2 2 2 2 2 2 2 2 2 2 2 2 2 2 2 2 2 2 2 2 2 5 6 6 6 6 6 6 4 2 2 2 2 2 2 0
0 2 2 2 2 2 2 4 6 6 6 6 5 2 2 2 2 2 2 2 2 2 2 2 2 2 2 2 2 2 2 2 2 2 2 5 6 6 6 6 6 6 4 2 2 2 2 2 2 0
0 2 2 2 2 2 2 4 6 6 6 6 5 2 2 2 2 2 2 2 2 2 2 2 2 2 2 2 2 2 2 2 2 2 2 5 6 6 6 6 6 6 4 2 2 2 2 2 2 0
0 2 2 2 2 2 2 4 6 6 6 6 5 2 2 2 2 2 2 2 2 2 2 2 2 2 2 2 2 2 2 2 2 2 5 6 6 6 6 6 6 6 4 2 2 2 2 2 2 0
0 2 2 2 2 2 2 4 6 6 6 6 5 2 2 2 2 2 2 2 2 2 2 2 2 2 2 2 2 2 2 2 2 5 6 6 6 6 6 6 6 6 4 2 2 2 2 2 2 0
0 2 2 2 2 2 2 4 6 6 6 6 5 2 2 2 4 2 2 2 2 2 2 2 2 2 2 2 2 2 2 2 5 2 6 6 6 6 6 6 6 6 4 2 2 2 2 2 2 0
0 2 2 2 2 2 2 4 6 6 6 6 5 2 2 2 2 2 2 2 2 2 2 2 2 2 2 2 2 2 2 5 3 3 6 6 6 6 6 6 6 6 4 2 2 2 2 2 2 0
0 2 2 2 2 2 2 4 6 6 6 6 6 5 2 2 2 2 2 2 2 2 2 2 2 2 2 2 2 2 5 3 3 3 6 6 6 6 6 6 6 6 4 2 2 2 2 2 2 0
0 2 2 2 2 2 2 4 6 6 6 6 6 6 5 2 2 2 2 2 2 2 5 5 5 5 5 5 5 5 6 6 6 6 6 6 6 6 6 6 6 6 4 2 2 2 2 2 2 0
0 2 2 2 2 2 2 4 6 6 6 6 6 6 6 5 2 2 2 2 2 5 6 6 6 6 6 6 6 6 6 6 6 6 6 6 6 6 6 6 6 6 4 2 2 2 2 2 2 0
0 2 2 2 2 2 2 4 6 6 6 6 6 6 6 6 5 5 5 5 5 6 6 6 6 6 6 6 6 6 6 6 6 6 6 6 6 6 6 6 6 6 4 2 2 2 2 2 2 0
0 2 2 2 2 2 2 4 3 3 3 6 6 6 6 6 6 6 6 6 6 6 6 6 6 6 6 6 6 6 6 6 6 6 6 6 6 6 6 6 6 6 4 2 2 2 2 2 2 0
0 2 2 2 2 2 2 4 6 6 6 6 6 6 6 6 6 6 6 6 6 6 6 6 6 6 6 6 6 6 6 6 6 6 6 6 6 6 6 6 6 6 4 2 2 2 2 2 2 0
0 2 2 2 2 2 2 4 4 4 4 4 4 4 4 4 4 4 4 4 4 4 4 4 4 4 4 4 4 4 4 4 4 4 4 4 4 4 4 4 4 4 4 2 2 2 2 2 2 0
0 2 2 2 2 2 2 2 2 2 2 2 2 2 2 2 2 2 2 2 2 2 2 2 2 2 2 2 2 2 2 2 2 2 2 2 2 2 2 2 2 2 2 2 2 2 2 2 2 0
0 2 2 2 2 2 2 2 2 2 2 2 2 2 2 2 2 2 2 2 2 2 2 2 2 2 2 2 2 2 2 2 2 2 2 2 2 2 2 2 2 2 2 2 2 2 2 2 2 0
0 2 2 2 2 2 2 2 2 2 2 2 2 2 2 2 2 2 2 2 2 2 2 2 2 2 2 2 2 2 2 2 2 2 2 2 2 2 2 2 2 2 2 2 2 2 2 2 2 0
0 2 2 2 2 2 2 2 2 2 2 2 2 2 2 2 2 2 2 2 2 2 2 2 2 2 2 2 2 2 2 2 2 2 2 2 2 2 2 2 2 2 2 2 2 2 2 2 2 0
0 2 2 2 2 2 2 2 2 2 2 2 2 2 2 2 2 2 2 2 2 2 2 2 2 2 2 2 2 2 2 2 2 2 2 2 2 2 2 2 2 2 2 2 2 2 2 2 2 0
0 2 2 2 2 2 2 2 2 2 2 2 2 2 2 2 2 2 2 2 2 2 2 2 2 2 2 2 2 2 2 2 2 2 2 2 2 2 2 2 2 2 2 2 2 2 2 2 2 0
0 2 2 2 2 2 2 2 2 2 2 2 2 2 2 2 2 2 2 2 2 2 2 2 2 2 2 2 2 2 2 2 2 2 2 2 2 2 2 2 2 2 2 2 2 2 2 2 2 0

